Aintree	Aint
Ascot	Ascot
Ayr	Ayr
Bangor	Bang
Bath	Bath
Beverley	Bev
Brighton	Brig
Carlisle	Carl
Cartmel	Cart
Catterick	Catt
Cheltenham	Chelt
Chepstow	Chep
Chester	Chest
Doncaster	Donc
Epsom	Epsm
Exeter	Extr
Fakenham	Fake
Ffos Las	FfosL
Folkstone	Folk
Fontwell	Font
Great Leighs	GLghs
Goodwood	Good
Hamilton	Ham
Haydock	Hayd
Hereford	Here
Hexham	Hex
Huntingdon	Hunt
Kelso	Kelso
Kempton	Kemp
Leicester	Leic
Lingfield	Ling
Ludlow	Ludl
Market Rasen	MrktR
Musselburgh	Muss
Newbury	Newb
Newcastle	Newc
Newmarket	Newm
Newton Abbot	Newt
Nottingham	Nott
Perth	Perth
Plumpton	Plump
Pontefract	Ponte
Redcar	Redc
Ripon	Ripon
Salisbury	Salis
Sandown	Sand
Sedgefield	Sedge
Southwell	Sthl
Stratford	Strat
Taunton	Taun
Thirsk	Thirsk
Towcester	Towc
Uttoxeter	Uttox
Warwick	Warw
Wetherby	Weth
Wincanton	Winc
Windsor	Wind
Wolverhampton	Wolv
Worcester	Worc
Yarmouth	Yarm
York	York

Ballinrobe	Ballin
Bellewstown	Belle
Clonmel	Clon
Cork	Cork
Down Royal 	DownR
Downpatrick	DownP
Dundalk	Dund
Fairyhouse	Fairy
Galway	Gal
Gowran Park	GowP
Killarney	Killar
Kilbeggan	Kilb
Laytown	Layt
Leopardstown	Leop
Limerick	Lim
Listowel	List
Naas	Naas
Navan	Navan
Punchestown	Punch
Roscommon	Rosc
Shelbourne	Shelb
Sligo	Sligo
The Curragh	Curr
Thurles	Thurl
Tipperary	Tipp
Tralee	Tral
Tramore	Tram
Wexford	Wex

Addington	Addi (NZL)
Alexandra Park	Alex (NZL)
Arawa Park	Araw (NZL)
Ascot Park	AsPk (NZL)
Ashburton	Ashb (NZL)
Avondale	Avon (NZL)
Awapuni	Awap (NZL)
Blenheim	Blen (NZL)
Cambridge	Camb (NZL)
Cromwell	Crom (NZL)
Dargaville	Darg (NZL)
Egmont	Egmo (NZL)
Ellerslie	Elle (NZL)
Foxton	Foxt (NZL)
Geraldine	Gdne (NZL)
Gisborne	Gisb (NZL)
Gore	Gore (NZL)
Greymouth	Grey (NZL)
Hastings	Hast (NZL)
Hatrick	Hatr (NZL)
Hawera	Hawe (NZL)
Hokitika	Hoki (NZL)
Hutt Park	Hutt (NZL)
Kurow	Kuro (NZL)
Makaraka	Maka (NZL)
Manawatu	Mana (NZL)
Matamata	Mata (NZL)
Manukau	Mkau (NZL)
Motukarara	Motu (NZL)
Mt Harding	MtHa (NZL)
Oamaru	Oama (NZL)
Omoto	Omot (NZL)
Otaki	Otak (NZL)
Paeroa	Paro (NZL)
Phar Lap	PLap (NZL)
Pukekohe	Puke (NZL)
Pukekura	Pkur (NZL)
Reefton	Reef (NZL)
Riccarton Park	Ricc (NZL)
Riverton	Rive (NZL)
Rotorua	Roto (NZL)
Ruakaka	Ruak (NZL)
Stratford	Stfd (NZL)
Taupo	Taup (NZL)
Tauherenikau	Tauh (NZL)
Tauranga	Taur (NZL)
Te Aroha	TeAr (NZL)
Te Awamutu	TeAw (NZL)
Te Kapua 	Tkap (NZL)
Te Kupenga	TKup (NZL)
Te Rapa	TRap (NZL)
Te Teko	TeTe (NZL)
Thames	Tmes (NZL)
Trentham	Tren (NZL)
Waikouaiti	Waik (NZL)
Waimate	Waim (NZL)
Waipukurau	Waip (NZL)
Wairoa	Wair (NZL)
Waterlea	Wlea (NZL)
Waverley	Wave (NZL)
Wanganui	Wnui (NZL)
Wingatui	Wing (NZL)
Winton	Wint (NZL)
Woodville	Wood (NZL)
Wyndham	Wynd (NZL)

Albuquerque	Albu
Aqueduct	Aque
Arapahoe Park	Arap
Arlington Park	Arl
Assiniboia Downs	Assin
Atlantic City	AtlanC
Bay Meadows	BayM
Belmont Park	Belmont
Beulah Park	Beulah
Blue Ribbon Downs	BlueRD
Calder Race Course	Calder
Canterbury Park	Cant
Charles Town	CharlT
Churchill Downs	Church
Colonial Downs	ColD
Del Mar	Del Mar
Delta Downs	DeltaD
Delaware Park	Delaw
Ellis Park	Ellis
Emerald Downs	Emer
Evangeline Downs	EvangD
Fair Grounds	FairG
Fair Meadows 	FairM
Fairmount Park	FairmP
Fairplex Park	FairP
Ferndale	Fern
Finger Lakes	FingL
Fonner Park	FonnP
Fort Erie	FortE
Fresno Fair	FresnoF
Golden Gate Fields	Golden
Great Lakes Downs	GreatLK
Gulfstream Park	Gulf
Hastings Park	Hast
Hawthorne	Hawth
Hialeah	Hialeah
Hollywood Park	HollyP
Hoosier Park	Hoos
Horsemen's Park	HorsemP
Indiana	Indiana
Keeneland	Keenl
Kentucky Downs	KentD
Laurel Park	Laurel
Les Bois Park	Les Bois
Lone Star Park	Lone St
Los Alamitos	Los Ala
Louisiana Downs	Louis
Marquis Downs	Marq
Meadowlands	Meadow
Monmouth Park	Monm
Mountaineer Park	MountP
Northlands Park	NorthP
Oaklawn Park	OaklP
Penn National	Penn
Philadelphia Park	Philly
Pimlico	Pimlico
Playfair	Playf
Pleasanton	Pleas
Portland Meadows	PortlM
Prairie Meadows	PrairM
Presque Isle Downs	PrIsleD 
Remington Park	RemmP
Retama Park	RetamP
Rillito Park	RillitP
River Downs	RiverD
Rockingham Park	RockP
Ruidoso Downs	RuidD
Sacramento	Sacra
Sam Houston	SamH
Santa Anita	Santa
Santa Rosa	SantaR
Saratoga	Sara
Solano	Solan
Sportsman's Park	SportsP
Stockton	Stock
Suffolk Downs	SuffD
Sunland Park	SunP
Sun Ray Park	SunRP
Tampa Bay Downs	Tampa
Thistledown	Thistle
Turf Paradise	TPara
Turfway Park	Turfway
Will Rogers Downs	WillRD 
Woodbine	Woodb
Woodlands	Woodl
Yavapai Downs	Yavap
Zia Park	ZiaP

Arlington	Arl (RSA)
Fairview	Fair (RSA)
Clairwood	Clair (RSA)
Greyville	Grey (RSA)
Scottsville	Scots (RSA)
Flamingo Park	FlamP (RSA)
Bloemfontein	Bloem (RSA) 
Gosforth	Gosf (RSA)
Newmarket	Newmkt (RSA)
Turffontein	Turf (RSA)
Vaal	Vaal (RSA)
Durbanville	Durban (RSA)
Kenilworth	Kenil (RSA)

Auteuil	Aut
Bordeaux	Bord
Cagnes Sur Mer	Cagnes
Chantilly	Chant
Clairfontaine	Cfont
Compiegne	Comp
Deauville	Deau
Dieppe	Dieppe
Enghien-Soisy	Engh
Longchamp	Long
Lyon Parilly	Lyon
Maisons-Laffite	MLaff
Pau	Pau
Saint-Cloud	Saint
Toulouse	Toul
Vichy	Vichy
Vincennes	Vincen

Baden-Baden	Baden
Bremen	Brem
Cologne	Col
Dortmund	Dort
Dusseldorf	Duss
Frankfurt	Frank
Hamburg	Hamb
Hannover	Hann
Krefeld	Kref
Munich	Munich
Neuss	Neuss

Nad Al Sheba	Nad Al
Jebel Ali	Jebel
Meydan	Meydan

